calcium: 钙
comic book: 漫画书
luminosity: 亮度
treat (against): 治疗（反对）
a multitude of: 众多
knit: 针织
TPO9 C1 (Advice on term paper topic): TPO9 C1（关于学期论文主题的建议）
permament: 永久
apprentice: 学徒
pedagogical: 教学法
capital investment: 资本投资
stumble onto: 偶然发现
ground: 地面
pronounced: 发音
denounce: 声讨
pesticide: 农药
grind: 研磨
extended: 扩展的
plaster: 石膏
perceive...as...: 把……当作……
be confronted with: 面临
sparing (with): 备用（有）
limestone: 石灰石
repressed: 压抑
inquiry: 询问
dynamics: 动力学
parched: 干枯
share: 分享
mural: 壁画
expressiveness: 表现力
bring on: 带上
inhibit: 抑制
